& & & & & & & & & & & & & & & & & & & & & &
& & & & & & & . . . . . . . . . . . . . . &
& & & & & & & . . . . . . . . . . . . . . .
& & & & & & & . . . . . . . . . . . . . . .
& & & & & & & . . . . . . . . . . . . . . .
& & & & & & & . . . . . . . . . . . . . . &
& & & & & & & & & & . . . . & & & & & & & &
& & & & & & & & & & . . . . & . . . . . . &
& & & & & & & & & & . . . . & . . . . . . &
& & & & & & & & & & . . . . & . . . . . . &
& & & & & & & & & & . . . . & . . . . . . &
& . . . . . . . . . . . . . . . . . . . . &
& . . . . . . . . . . . . . . . . . . . . &
& . . . . . . . . . . . . . . . . . . . . &
& . . . . . . . . . . . . . . . . . . . . &
& . . . . . . . . . P . . . . . . . . . . &
& . . . . . . . . . . . . . . . . . . . . &
& . . . . . . . . . . . . . . . . . . . . &
& . . . . . . . . . . . . . . . . . . . . &
& & & & & & & & & & & & & & & & & & & & & &
