& & & & & & @ @ @ @ @ @ @ @ @ @ @ @ @ @ @ @
& & & & & & @ . . . . . . . . . . . . . . @
& & & & & & @ . . . . . . . . . . . . . . .
& & & & & & @ . . . . . . . . . . . . . . .
& & & & & & @ . . . . . . . . . . . . . . .
& & & & & & @ . . . . . . . . . . . . . . @
& & & & & & @ . . . . . . . . . . . . . . @
& & & & & & @ . . . . . . . . . . . . . . @
& & & & & & @ @ @ @ . . . . @ @ @ @ @ @ @ @
& & & & & & & & & & . . . . & & & & & & & &
& & & & & & & & & & . . . . & . . . . . . &
& & & & & & & & & & . . . . & . . . . . . &
& & & & & & & & & & . . . . & . . . . . . &
& & & & & & & & & & . . . . & . . . . . . &
& . . . . . . . . . . . . . . . . . . . . &
& . . . . . . . . . . . . . . . . . . . . &
& . . . . . . . . . . . . . . . . . . . . &
& . . . . . . . . . . . . . . . . . . . . &
& . . . . . . . . . P . . . . . . . . . . &
& . . . . . . . . . . . . . . . . . . . . &
& . . . . . . . . . . . . . . . . . . . . &
& . . . . . . . . . . . . . . . . . . . . &
& & & & & & & & & & & & & & & & & & & & & &
